src/app/_archive/parcel-test/page.tsx	/_archive/parcel-test
src/app/_archive/projects-acquisition/page.tsx	/_archive/projects-acquisition
src/app/_archive/projects-analysis/market-data/page.tsx	/_archive/projects-analysis/market-data
src/app/_archive/projects-analysis/page.tsx	/_archive/projects-analysis
src/app/_archive/projects-analysis/sensitivity/page.tsx	/_archive/projects-analysis/sensitivity
src/app/_archive/projects-capitalization/operations/page.tsx	/_archive/projects-capitalization/operations
src/app/_archive/projects-capitalization/waterfall/page.tsx	/_archive/projects-capitalization/waterfall
src/app/_archive/projects-development/budget/page.tsx	/_archive/projects-development/budget
src/app/_archive/projects-development/phasing/page.tsx	/_archive/projects-development/phasing
src/app/_archive/projects-documents-files/page.tsx	/_archive/projects-documents-files
src/app/_archive/projects-landscaper/page.tsx	/_archive/projects-landscaper
src/app/_archive/projects-opex-accounts/page.tsx	/_archive/projects-opex-accounts
src/app/_archive/projects-opex/page.tsx	/_archive/projects-opex
src/app/_archive/projects-overview/page.tsx	/_archive/projects-overview
src/app/_archive/projects-planning/budget/page.tsx	/_archive/projects-planning/budget
src/app/_archive/projects-planning/land-use/page.tsx	/_archive/projects-planning/land-use
src/app/_archive/projects-planning/market/page.tsx	/_archive/projects-planning/market
src/app/_archive/projects-results/page.tsx	/_archive/projects-results
src/app/_archive/projects-sales-marketing/page.tsx	/_archive/projects-sales-marketing
src/app/_archive/projects-validation/page.tsx	/_archive/projects-validation
src/app/_archive/projects-valuation-income-approach/income-approach/page.tsx	/_archive/projects-valuation-income-approach/income-approach
src/app/_archive/projects-valuation/page.tsx	/_archive/projects-valuation
src/app/_archive/properties/[id]/analysis/page.tsx	/_archive/properties/[param]/analysis
src/app/_archive/property/[id]/page.tsx	/_archive/property/[param]
src/app/admin/benchmarks/cost-library/page.tsx	/admin/benchmarks/cost-library
src/app/admin/changelog/page.tsx	/admin/changelog
src/app/admin/feedback/page.tsx	/admin/feedback
src/app/benchmarks/products/page.tsx	/benchmarks/products
src/app/benchmarks/unit-costs/page.tsx	/benchmarks/unit-costs
src/app/contacts/page.tsx	/contacts
src/app/diligence/page.tsx	/diligence
src/app/forgot-password/page.tsx	/forgot-password
src/app/ingestion/page.tsx	/ingestion
src/app/lease/[id]/page.tsx	/lease/[param]
src/app/onboarding/page.tsx	/onboarding
src/app/phases/page.tsx	/phases
src/app/preferences/page.tsx	/preferences
src/app/projects/[projectId]/budget/page.tsx	/projects/[param]/budget
src/app/projects/[projectId]/documents/page.tsx	/projects/[param]/documents
src/app/projects/[projectId]/napkin/page.tsx	/projects/[param]/napkin
src/app/projects/[projectId]/napkin/waterfall/page.tsx	/projects/[param]/napkin/waterfall
src/app/projects/[projectId]/settings/page.tsx	/projects/[param]/settings
src/app/reset-password/page.tsx	/reset-password
src/app/settings/budget-categories/page.tsx	/settings/budget-categories
src/app/settings/contact-roles/page.tsx	/settings/contact-roles
src/app/settings/taxonomy/page.tsx	/settings/taxonomy
